There is no reservation made for 1st!
1st has reserved 0 2-1
2nd could not reserve a seat!
2nd has reserved 0 1-1
3rd has reserved 1 1-0 by emptiest block

0
~~~~~~~
0 : --- --- --- --- 
1 : --- 2nd --- --- 
2 : --- 1st --- --- 
3 : --- --- --- --- 
=======

1
~~~~~~~
0 : --- --- --- --- 
1 : 3rd --- --- --- 
2 : --- --- --- --- 
3 : --- --- --- --- 
=======

2
~~~~~~~
0 : --- --- --- --- 
1 : --- --- --- --- 
2 : --- --- --- --- 
3 : --- --- --- --- 
=======

3
~~~~~~~
0 : --- --- --- --- 
1 : --- --- --- --- 
2 : --- --- --- --- 
3 : --- --- --- --- 
=======

4th has reserved 2 1-0 by emptiest block
5th has reserved 0 3-0 by emptiest block

0
~~~~~~~
0 : --- --- --- --- 
1 : --- 2nd --- --- 
2 : --- 1st --- --- 
3 : 5th --- --- --- 
=======

1
~~~~~~~
0 : --- --- --- --- 
1 : 3rd --- --- --- 
2 : --- --- --- --- 
3 : --- --- --- --- 
=======

2
~~~~~~~
0 : --- --- --- --- 
1 : 4th --- --- --- 
2 : --- --- --- --- 
3 : --- --- --- --- 
=======

3
~~~~~~~
0 : --- --- --- --- 
1 : --- --- --- --- 
2 : --- --- --- --- 
3 : --- --- --- --- 
=======

5th could not reserve a seat!
5th could not reserve a seat!
6th has reserved 1 3-0 by emptiest block
7th has reserved 2 3-0 by emptiest block

0
~~~~~~~
0 : --- --- --- --- 
1 : --- 2nd --- --- 
2 : --- 1st --- --- 
3 : 5th --- --- --- 
=======

1
~~~~~~~
0 : --- --- --- --- 
1 : 3rd --- --- --- 
2 : --- --- --- --- 
3 : 6th --- --- --- 
=======

2
~~~~~~~
0 : --- --- --- --- 
1 : 4th --- --- --- 
2 : --- --- --- --- 
3 : 7th --- --- --- 
=======

3
~~~~~~~
0 : --- --- --- --- 
1 : --- --- --- --- 
2 : --- --- --- --- 
3 : --- --- --- --- 
=======


